AAAAAAAAAAAAAAAAAAAAAAA
A                     A
A AAAA           ! V  A
A A                   A
A A J              O  A
A A   L               A
A                  7  A
A                     A
A                     A
A                     A
A                     A
A { } | +             A
A                     A
A : ' Z               A
A          P          A
AAAAAAAAAAAAAAAAAAAAAAA
 