TTTTTTTTTTTTTTTTTTTTTTT
T                     T
T 5               V   T
T                     T
T                     T
T                  G  T
T                     T
T                     T
T                     T
T                     T
T                 T   T
T               P     T
T                     T
T                     T
T                     T
TTTTTTTTTTTTTTTTTTTTTTT
 