WWWWWWWWWWWWWWWWWWWWWWW
W                     W
W          ;          W
W                     W
W        ; ? ;        W
W                     W
W          ;          W
W                     W
W                     W
W                     W
W                     W
W        !   !        W
W                     W
W          P          W
W                     W
WWWWWWWWWWWWWWWWWWWWWWW
 