AAAAAAAAAAAAAAAAAAAAAAA
A                     A
A AAAA             V  A
A A                   A
A A P              O  A
A A                   A
A                  8  A
A                     A
A                     A
A                     A
A                     A
A                     A
A                     A
A                   9 A
A                     A
AAAAAAAAAAAAAAAAAAAAAAA
 