TTTTTTTTTTTTTTTTTTTTTTT
T                     T
T P               V   T
T                     T
T                     T
T                  G  T
T                  4  T
T                     T
T                     T
T                     T
T                 T   T
T Z X C           H   T
T > N M               T
T                     T
T                     T
TTTTTTTTTTTTTTTTTTTTTTT
 